0011111010
1000000010
1110111110
0000111100
1110010001
0000010101
0110111101
1110010101
1011011100
1110000001